##############################
#.......#####.........#####..#
#.......##C##.........##S##..#
#............................#
#.....GGGG..............GG...#
#.....GGGG..............GG...#
#.....GGGG..............GG...#
#............................#
#............................#
#............................#
#.....GGGG..................##
#.....GGGG..................W#
#.....GGGG..................##
#............................#
##############################