##############################
#............................#
#...GGGG..............GGGG...#
#...GGGG..............GGGG...#
#...GGGG.....T........GGGG...#
#............................#
#............................#
#...........................W#
#............................#
#............................#
#............................#
#B...GGGG....................#
#....GGGG....................#
#....GGGG....................#
##############################