##############################
#............................#
#...GGGGGGGGGG...............#
#...GGGGGGGGGG.....T.........#
#...GGGGGGGGGG...............#
#............................#
#............................#
#B...........................#
#####........................#
#####........................#
#W...........................#
#........................GGGG#
#........................GGGG#
#........................GGGG#
##############################