##############################
#.......................W....#
#......GGGGGGGG..............#
#......GGGGGGGG..............#
#......GGGGGGGG..............#
#............................#
#............................#
#............................#
#............................#
#............................#
#...........................B#
#...T..........GGG...........#
#.................GGGG.......#
#............................#
##############################