##############################
#...........#####............#
#...........##W##............#
#....GGGGGG........GGGGGG....#
#....GGGGGG........GGGGGG....#
#............................#
#............................#
#............................#
#............................#
#......T.....................#
#............................#
#....GGG.....................#
#....GGG.....................#
#........................B...#
##############################