##############################
#..............L.............#
########.....................#
#............................#
#........................#####
#............................#
########.....................#
#............................#
#............................#
#....................#########
#............................#
#............................#
#####....................#####
#..............B.............#
##############################